XXXXXXXXXXXXXXXXXXXXXXX
XXXXXXXPcccCXCccXXXXXXX
XXXXXXXXXcXcXXXCXXXXXXX
XXXXCcccccXccCccXXXXXXX
XXXXXXXXXXXXXXXcXXXXXXX
XXXXXLlllLlllLXCcccCXXX
XXXXXlXXXlmMmlXXXXXcXXX
XLlllLXXXlmBmlXXXXXccCX
XlXeXXXXXlmmmlXXXXXXXuX
XLXEeeeeXLlllLXUuuuUXuX
XXXXXXXeXXXXXXXuXuXXXuX
XEeeeeeEXUuuuuuUXUuuuUX
XeXXXXXXXuXXXXXXXXXXXXX
XEeeEeeEXUXXXXXXXXXXXXX
XeXXXXXeXuXXXXXXXXXXXXX
XEeeXXXeXuuUXXXXXXXXXXX
XXXeXXXeXXXuXXXXXXXXXXX
XXXEXRrrrRXrrrXXXXXXXXX
XXXXXrXXXXXrRrXXXXXXXXX
XXXXXRrrrRXrrrXXXXXXXXX
XXXXXXXrXrXXXrXXXXXXXXX
XXXXXXXRXRrrrRXXXXXXXXX
XXXXXXXXXXXXXXXXXXXXXXX
